NO ./textures/n_wall.xpm
SO ./textures/s_wall.xpm
WE ./textures/w_wall.xpm
EA ./textures/e_wall.xpm

F 255,75,0
C 0,191,128

        111111111111111111111111111
        1N00000001100000000000001
        101100000111000000001111
        1001000000010000000010001
111111111111000001110000000001111
1001  1011011000001111111111111111
11111111111111011100100010001
11110111111111011101000010001
11000000110101011100100010001
100010000000000011000000100011
1001 100000000001101010010001101
1100110111010101111101111000111
11111111 1111111 1111111111111